NO            textures/redbrick.xpm
SO       textures/colorstone.xpm
WE      textures/greystone.xpm
EA   textures/wood.xpm

F 102, 051, 000
C 102, 153, 255


        1111111111111111111111111
        1000000000000000000000001
        1100000000000000000000001
        1000000000000000000000001
111111111000000000000000000000001
100001111110000000000000000001111
100001000010001100000000000001
1000010E000100000000000000001
10000111111000000000000000001
10000111111000000000000000001
10000000000000000001010000011
11000001110101011111011110101
11110111 1110111 101111010001
11111111 1111111 111111111111

